##########
#        #
#  ####  #
#  #     #
#        #
##########