###############
#1.   #   . * #
# ### # ##### #
# . * .   # # #
##### ### # # #
# . . # . # . #
# # # # # # # #
# . #   * #   #
# ########### #
# . * .   . # #
# ######### # #
# . . . * .   #
##### ####### #
#     .       #
###############