##########################
#                        #
#   ############     ### #
#   #		#   #  # #
#   #	   #	#   #  # #
#   #	   #	#   #  # #
#   #	   #	#   #  # #
#   ########	#####  # #
#		    #### # 
#  #     #   #     	 #
#  #######   #     	 #
#                  	 #
##########################